11111
10E01
00001
1PC01
11111
