1111111111111
1P010000000C1
1P00011111001
1P0011E000001
1111111111111
