11111
10E01
10000
1PC01
11111
