11111
10E01
10001
1PC01
11110
