1111111111111
1P01[[[[]]]]1
1000011111001
100011E0000C1
1111111111111
