111111111111111111111111111111111
1KCEKKKKKKKKKKKKKKKKKKKKKKKKKKKK1
1KKKKKKKKKKKKKKKKKKKKKKKKKKKKKKK1
1KKKKKKKKKKKKKKKKKKKKKKKKKKKKKKK1
1KKKKKKKKKKKKKKKKKKKKKKKKKKKKKKK1
1KKKKKKKKKKKKKKKKKKKKKKKKKKKKKKK1
1KKKKKKKKKKKKKKKKKKKKKKKKKKKKKKK1
1KKKKKKKKKKKKKKKKKKKKKKKKKKKKKKK1
1KKKKKKKKKKKKKKKKKKKKKKKKKKKKKKK1
1KKKKKKKKKKKKKKKKKKKKKKKKKKKKKKK1
1KKKKKKKKKKKKKKKKKKKKKKKKKKKKKKK1
1KKKKKKKKKKKKKKKKKKKKKKKKKKKKKKK1
1KKKKKKKKKKKKKKKKKKKKKKKKKKKKKKK1
1KKKKKKKKKKKKKKKKKKKKKKKKKKKKKKK1
1KKKKKKKKKKKKKKKKKKKKKKKKKKKKKKK1
1KKKKKKKKKKKKKKKKKKKKKKKKKKKKKKK1
1KKKKKKKKKKKKKKKPKKKKKKKKKKKKKKK1
1KKKKKKKKKKKKKKKKKKKKKKKKKKKKKKK1
1KKKKKKKKKKKKKKKKKKKKKKKKKKKKKKK1
1KKKKKKKKKKKKKKKKKKKKKKKKKKKKKKK1
1KKKKKKKKKKKKKKKKKKKKKKKKKKKKKKK1
1KKKKKKKKKKKKKKKKKKKKKKKKKKKKKKK1
1KKKKKKKKKKKKKKKKKKKKKKKKKKKKKKK1
1KKKKKKKKKKKKKKKKKKKKKKKKKKKKKKK1
1KKKKKKKKKKKKKKKKKKKKKKKKKKKKKKK1
1KKKKKKKKKKKKKKKKKKKKKKKKKKKKKKK1
1KKKKKKKKKKKKKKKKKKKKKKKKKKKKKKK1
1KKKKKKKKKKKKKKKKKKKKKKKKKKKKKKK1
1KKKKKKKKKKKKKKKKKKKKKKKKKKKKKKK1
1KKKKKKKKKKKKKKKKKKKKKKKKKKKKKKK1
1KKKKKKKKKKKKKKKKKKKKKKKKKKKKKKK1
1KKKKKKKKKKKKKKKKKKKKKKKKKKKKKKK1
1KKKKKKKKKKKKKKKKKKKKKKKKKKKKKKK1
1KKKKKKKKKKKKKKKKKKKKKKKKKKKKKKK1
111111111111111111111111111111111
