1111111111111
1KKKKKKKKKKC1
10KCK0K0000K1
1P0011EK00001
1111111111111
