1111111111111111111111111111111111
1E0000000000000C00000C0000K0000001
10100101001000001010010000K0010101
10100100101010100010010000K0010101
100000000C00C0000000000000K00000C1
1E0000000000000C00000C0000K0000001
10100101001000001010010000K0010101
10100100101010100010010000K0010101
100000000C00C0000000000000K00000C1
1E0000000000000C00000C0000K0000001
1010010100100000101001000000010101
1010010010101010001001000000010101
1P0000000C00C0000000000000000000C1
1111111111111111111111111111111111
