1111111111111111111111111111111111
1EK00010000000KC0000KCK00000000001
10101011001000KK1010010000000101K1
10101010101010100010010000000100K1
1P0010000C00C00000000000000000KKC1
1111111111111111111111111111111111
