1111111111111111111111
1P10000100100100000001
10101011101101000001K1
101010010000010KK00101
10101000000000KEEK0101
10101000010000KEEK0101
101010000100000KK00101
10101010111100000001K1
10001KCK010001001101C1
1111111111111111111111
