111111111111111111111
110011011110001111111
101100101101110101111
101101110010101010111
110010100111011011011
111111011000101010111
1PCE11111111110101111
111111111111111111111
